0 26 3 3 3 3 3 3 3 3 3 3 3 3 3 3 3 3 3 3 3 3 3 3 3 3 3 3 3 3 3 3 3 3 3 3 3 27 0 0 0 0 0 0 0 0 0 0 0 0 
0 25 10 10 10 10 10 10 10 10 31 10 10 10 10 10 10 10 10 10 10 10 10 10 10 10 10 10 10 10 10 10 10 10 10 10 10 15 0 0 0 0 0 0 0 0 0 0 0 0 
0 25 10 10 31 10 10 10 31 10 10 10 10 10 31 10 10 10 10 10 10 31 10 10 10 10 10 10 10 10 31 10 10 10 10 10 10 15 0 0 0 0 0 0 0 0 0 0 0 0 
0 25 10 10 10 10 10 10 10 10 31 10 10 10 10 10 10 10 10 10 10 10 10 10 10 10 31 10 10 10 10 10 10 10 10 10 10 15 0 0 0 0 0 0 0 0 0 0 0 0 
0 29 30 30 30 30 5 10 10 34 34 34 34 10 34 10 10 10 10 31 10 10 10 10 10 10 10 10 10 34 34 10 10 10 10 10 10 15 0 0 0 0 0 0 0 0 0 0 0 0 
0 0 0 0 0 2 25 10 10 12 12 12 12 12 12 12 12 12 12 12 12 12 12 12 12 12 12 12 12 19 34 10 31 10 10 10 10 15 0 0 0 0 0 0 0 0 0 0 0 0 
0 0 0 0 0 1 25 10 10 11 11 11 11 11 11 11 11 11 11 11 11 11 11 11 11 11 11 11 17 17 10 10 10 10 10 10 10 15 0 0 0 0 0 0 0 0 0 0 0 0 
0 26 3 3 3 3 6 10 10 34 34 34 34 10 34 10 10 10 34 10 10 10 10 10 10 10 10 31 13 16 10 10 10 10 10 10 10 15 0 0 0 0 0 0 0 0 0 0 0 0 
0 25 10 31 10 10 10 34 10 10 10 10 10 10 31 10 10 10 34 10 10 31 10 10 34 10 10 10 13 16 10 10 10 10 10 10 10 15 0 0 0 0 0 0 0 0 0 0 0 0 
0 25 10 10 10 10 10 10 10 10 10 34 10 10 10 10 10 10 10 10 34 10 10 10 10 10 10 10 13 16 10 10 10 10 10 10 10 15 0 0 0 0 0 0 0 0 0 0 0 0 
0 25 10 10 10 10 34 10 10 10 10 10 10 10 34 10 10 10 10 10 10 10 34 10 10 10 34 10 13 16 10 10 34 34 10 34 10 15 0 0 0 0 0 0 0 0 0 0 0 0 
0 25 10 10 10 10 10 10 10 10 10 10 10 10 10 10 10 10 10 10 10 10 10 10 10 10 10 10 13 16 10 10 34 10 10 34 10 15 0 0 0 0 0 0 0 0 0 0 0 0 
0 25 10 10 10 10 10 31 10 10 10 31 10 10 10 10 10 34 10 10 10 10 10 10 10 10 31 10 13 16 10 10 10 10 10 10 10 15 0 0 0 0 0 0 0 0 0 0 0 0 
0 25 10 34 10 10 10 10 10 10 10 10 10 10 31 10 10 10 10 10 31 10 10 34 10 10 10 10 13 16 10 10 10 10 31 10 10 15 0 0 0 0 0 0 0 0 0 0 0 0 
0 25 10 10 10 10 10 10 34 10 10 10 10 34 10 10 10 10 10 10 10 10 10 10 10 10 10 34 13 16 10 10 10 10 10 10 10 15 0 0 0 0 0 0 0 0 0 0 0 0 
0 25 10 10 10 10 10 10 10 10 31 10 10 10 10 10 10 34 10 10 10 10 10 10 18 12 12 12 17 16 10 10 10 10 34 10 10 15 0 0 0 0 0 0 0 0 0 0 0 0 
0 25 10 10 10 31 10 10 10 10 10 10 10 34 10 10 10 10 10 10 34 10 10 10 13 17 17 11 11 20 10 34 10 10 10 10 10 15 0 0 0 0 0 0 0 0 0 0 0 0 
0 25 10 10 10 10 10 34 10 10 10 10 31 10 10 10 31 10 10 10 10 10 10 10 13 17 16 10 10 10 10 10 10 10 10 10 10 15 0 0 0 0 0 0 0 0 0 0 0 0 
0 25 10 10 34 10 10 10 10 10 10 10 10 10 34 10 10 10 10 10 10 10 10 10 13 17 16 10 10 34 10 10 31 10 34 10 10 15 0 0 0 0 0 0 0 0 0 0 0 0 
0 25 10 10 10 10 10 10 10 10 10 10 10 10 10 10 10 10 10 10 10 10 10 10 13 17 16 10 10 10 10 10 10 10 10 10 10 15 0 0 0 0 0 0 0 0 0 0 0 0 
0 25 10 10 10 10 34 10 31 10 10 34 10 10 10 34 10 10 10 34 10 10 10 10 13 17 16 10 10 10 10 10 10 10 10 10 10 15 0 0 0 0 0 0 0 0 0 0 0 0 
0 25 10 10 10 10 10 10 10 10 10 10 10 31 10 10 10 31 10 10 10 10 10 10 13 17 16 10 34 10 34 10 34 10 31 10 10 15 0 0 0 0 0 0 0 0 0 0 0 0 
0 25 10 34 10 10 10 10 31 10 10 10 10 10 10 10 10 10 10 10 34 10 10 10 13 17 16 10 10 10 10 10 10 10 10 10 10 15 0 0 0 0 0 0 0 0 0 0 0 0 
0 25 10 10 10 10 10 31 10 10 34 10 10 10 10 10 10 10 34 10 10 34 10 10 13 17 16 10 10 10 10 10 10 10 10 34 34 15 0 0 0 0 0 0 0 0 0 0 0 0 
0 25 10 10 10 10 10 10 10 10 10 10 10 10 31 10 34 10 10 10 10 10 10 10 13 17 16 10 34 10 10 31 10 34 10 10 10 15 0 0 0 0 0 0 0 0 0 0 0 0 
0 25 10 10 10 10 10 10 10 10 10 10 10 10 10 10 10 10 10 10 10 10 10 10 13 17 16 10 10 10 10 10 10 10 10 34 10 15 0 0 0 0 0 0 0 0 0 0 0 0 
0 25 10 10 10 10 10 10 10 10 10 10 10 10 10 10 10 10 10 10 10 31 10 10 13 17 16 10 10 31 10 10 10 34 10 10 10 15 0 0 0 0 0 0 0 0 0 0 0 0 
0 29 30 30 30 30 30 30 30 30 30 30 30 30 30 30 30 30 30 30 30 32 34 34 13 17 16 34 34 32 30 30 30 30 30 30 30 28 0 0 0 0 0 0 0 0 0 0 0 0 
0 0 0 0 0 0 0 0 0 0 0 0 0 0 0 0 0 0 0 0 0 32 12 12 17 17 17 12 12 32 0 0 0 0 0 0 0 0 0 0 0 0 0 0 0 0 0 0 0 0 
0 0 0 0 0 0 0 0 0 0 0 0 0 0 0 0 0 0 0 0 0 32 17 17 17 17 17 17 17 32 0 0 0 0 0 0 0 0 0 0 0 0 0 0 0 0 0 0 0 0 
0 0 0 0 0 0 0 0 0 0 0 0 0 0 0 0 0 0 0 0 0 32 17 17 17 17 17 17 17 32 0 0 0 0 0 0 0 0 0 0 0 0 0 0 0 0 0 0 0 0 
0 0 0 0 0 0 0 0 0 0 0 0 0 0 0 0 0 0 0 0 0 32 17 17 17 17 17 17 17 32 0 0 0 0 0 0 0 0 0 0 0 0 0 0 0 0 0 0 0 0 
0 0 0 0 0 0 0 0 0 0 0 0 0 0 0 0 0 0 26 3 3 23 34 10 10 10 10 10 34 23 3 3 3 3 3 3 3 3 3 3 3 3 3 3 3 3 3 3 3 27 
0 0 0 0 0 0 0 0 0 0 0 0 0 0 0 0 0 0 25 32 32 23 34 10 10 10 10 10 34 23 32 32 32 32 32 32 32 32 32 32 32 32 32 32 32 32 32 32 32 15 
0 0 0 0 0 0 0 0 0 0 0 0 0 0 0 0 0 0 25 32 34 34 34 10 10 10 10 10 34 34 34 34 34 34 34 34 34 34 34 34 34 34 34 34 34 34 34 34 32 15 
0 0 0 0 0 0 0 0 0 0 0 0 0 0 0 0 0 0 25 32 34 10 10 10 10 10 10 10 10 10 10 10 10 10 10 10 10 10 10 10 10 10 10 10 10 10 10 34 32 15 
0 0 0 0 0 0 0 0 0 0 0 0 0 0 0 0 0 0 25 32 34 10 10 10 10 10 10 10 10 10 10 10 10 10 10 10 10 10 10 10 10 10 10 10 10 10 10 34 32 15 
0 0 0 0 0 0 0 0 0 0 0 0 0 0 0 0 0 0 25 32 34 10 10 10 10 10 10 10 10 10 10 10 10 10 10 31 10 10 10 10 10 10 10 10 10 10 10 34 32 15 
0 0 0 0 0 0 0 0 0 0 0 0 0 0 0 0 0 0 25 32 34 10 10 10 10 10 10 10 10 10 10 10 10 10 10 10 10 10 10 10 10 10 10 10 10 10 10 34 32 15 
0 0 0 0 0 0 0 0 0 0 0 0 0 0 0 0 0 0 25 32 34 31 10 10 10 10 10 10 10 10 10 10 10 10 10 10 10 10 10 10 32 32 32 10 32 32 32 34 32 15 
0 0 0 0 0 0 0 0 0 0 0 0 0 0 0 0 0 0 25 32 34 10 10 10 10 31 10 10 10 10 10 10 10 10 10 10 10 10 10 10 32 10 10 10 10 10 32 34 32 15 
0 0 0 0 0 0 0 0 0 0 0 0 0 0 0 0 0 0 25 32 34 10 10 10 10 10 10 10 10 10 10 10 10 10 10 10 10 10 10 10 32 10 10 10 10 10 32 34 32 15 
0 0 0 0 0 0 0 0 0 0 0 0 0 0 0 0 0 0 25 32 34 10 10 10 10 10 10 10 10 10 10 10 10 10 10 10 10 10 10 10 32 10 10 10 10 10 32 34 32 15 
0 0 0 0 0 0 0 0 0 0 0 0 0 0 0 0 0 0 25 32 34 10 10 10 10 10 10 10 10 10 10 10 10 10 10 10 10 10 10 10 32 10 10 10 10 10 32 34 32 15 
0 0 0 0 0 0 0 0 0 0 0 0 0 0 0 0 0 0 25 32 34 10 10 10 10 10 10 10 10 10 10 10 31 10 10 10 10 10 10 10 32 10 10 10 10 10 32 34 32 15 
0 0 0 0 0 0 0 0 0 0 0 0 0 0 0 0 0 0 25 32 34 31 10 10 10 10 10 10 10 10 10 10 10 10 10 10 10 10 10 10 32 32 32 32 32 32 32 34 32 15 
0 0 0 0 0 0 0 0 0 0 0 0 0 0 0 0 0 0 25 32 34 10 10 10 10 10 10 10 10 10 10 10 10 10 10 10 10 10 10 10 10 10 10 10 10 10 31 34 32 15 
0 0 0 0 0 0 0 0 0 0 0 0 0 0 0 0 0 0 25 32 34 34 34 34 34 34 34 31 34 34 34 34 34 34 34 34 34 34 34 34 34 34 34 34 34 34 34 34 32 15 
0 0 0 0 0 0 0 0 0 0 0 0 0 0 0 0 0 0 25 32 32 32 32 32 32 32 32 32 32 32 32 32 32 32 32 32 32 32 32 32 32 32 32 32 32 32 32 32 32 15 
0 0 0 0 0 0 0 0 0 0 0 0 0 0 0 0 0 0 29 30 30 30 30 30 30 30 30 30 30 30 30 30 30 30 30 30 30 30 30 30 30 30 30 30 30 30 30 30 30 28 
